%%%%%%
%....%
%.%..%
%1..B%
%P%%%%
% %%%%
%%%%%%
