%%%%%%%%
%%%...%%
%BP...%%
%%%..1%%
%B%%..%%
%.% 2.%%
%..3..B%
%...B  %
%%%%%%%%
