%%%%%%
%... %
%.%. %
%...B%
%P%%%%
% %%%%
%%%%%%
