%%%%%%%
%.....%
%.%.P.%
%.3.1%%
%%52.%%
%...4%%
%....%%
%%%%%%%
